################################
################################
#                              #
#                              #
#                              #
#                              #
#                              #
# @    ~   ~       ~       ~   #
#               ###            #
#                 #X           #
################# ##############
#             &                #
#                              #                               
################################