################################
################################
#         #        #    #     X#
#         #        #    #      #
#         #        #    #      #
#    @    #        #    #      #
#         #        #    #      #
#         #####    # ~  #      #
#       &     #    ###  #      #
#             *         #      #
#         ############# #      #
#         #                    #
#         #                    #
#         #                    #
#         #                    #
#         #                    #
#         #                    #
################################