################################
################################
#          ~ . #               #
#              #     *         #
#              # ~   @ &       #
#          #####               #
#   ##  ####   #.        *     #
#   #   #      #   ~           #
#   # #### ##  ###   #######   #
#   # #     # ~  ## #     X#   #
#   # ## ## ###     #  #####   #
#   # #     ~ #######    # #   #
#   # # ## ####  ####### # #   #
#   # #    #         #   # #   #
#   # #### #  ### #### ### #   #
#   #    #      #          #   #
#   #        #     #       #   #
################################