################################
################################
#                  #    #     X#
#                  #    #      #
#                  #    #      #
#    @             #    #      #
#                  #    #      #
#                  # ~  #      #
#       &          ###  #      #
#                       #      #
#         ############# #      #
#         #                    #
#         #                    #
#         #                    #
#         #                    #
#         #                    #
#         #                    #
################################