################################
################################
#   #   #            #         #
# @ #   #            #         #
#   #   # ########## #         #
#   #   # #        # #         #
#   #   # # ###### # #         #
#   #   # # #    # # #         #
#   ##### # #    # # #         #
#         # #    # # #         #
########### #   ~# # #      ~  #
#           # #### # #         #
#   #########      # #         #
#   #   ~ #        # #   ~     #
#   #     #          #         #
# & #     #     ######        X#
#   #                          #
################################