##############################
##############################
#          ~ . #&            #
#              #     *       #
#              # ~   @       #
#          #####             #
#   ##  ####   #.        *   #
#   #   #      #   ~         #
#   # #### ##  ###   ####### #
#   # #     # ~  ## #     X# #
#   # ## ## ###     #  ##### #
#   # #     ~ #######    # # #
#   # # ## ####  ######  # # #
#   # #    #    #        # # #
#   # #### #  ### ######## # #
#   #    #      #          # #
#   #        #     #       # #
##############################